▄▄▄▄▄▄▄▄▄▄▄▄▄▄▄▄▄▄▄▄▄▄▄▄
█ █▄▄▄▄▄ █S▄▄ █        █
█▄▄▄▄▄▄▄▄▄▄█ ▄█        █
█                      █
█                      █
█                      █
█                      █
█                      █
█                      █
█                      █
█                      █
█                      █
█                      █
█                      █
█                      █
█                      █
█                      █
█                      █
█                      █
█                      █
▀▀▀▀▀▀▀▀▀▀▀▀▀▀▀▀▀▀▀▀▀▀▀▀