▄▄▄▄▄▄▄▄▄▄▄▄▄▄▄▄▄▄▄▄▄▄▄▄
█ █▄▄▄▄▄ █ ▄▄ █        █
█▄▄▄▄▄▄▄▄▄▄█ ▄█        █
█                      █
█                      █
█                      █
█                      █
█                      █
█                      █
█                      █
█                      █
█                      █
█                      █
█                      █
█                      █
█                      █
█                      █
█                      █
█                      █
█                      █
▀▀▀▀▀▀▀▀▀▀▀▀▀▀▀▀▀▀▀▀▀▀▀▀