▄▄▄▄▄▄▄▄▄▄▄▄▄▄▄▄▄▄▄▄▄▄▄▄
█S█▄▄▄▄▄ █ ▄▄ █ ▄ ▀ ▄ ▄█
█▄▄▄▄▄▄▄▄▄▄█ ▄█ █ █ █▄ █
█ ▄ █ ▄▄▄ █ ▄▄▄▄█ █▄█ ▄█
█ █▄▄▄▄▄█ █ ▄█▄▄▄ ▄ █▄ █
█ █ ██▀ ▄▄▄ █ ▄█ ▄▀ █ ▄█
█ █  █  █  █ ▄██▄█ ▄▄▄▄█
█ █ ██▄▀█ █ ▄█   █ █▀▀▀█
█ █▄▄▄▄▄▄▄▄▄▄▄▄▄▄▄ ▄▄█ █
█▄▄▄▄ ▄ █ ▄▄▄▄▄▄ █  █ ▄█
█ ▄ █ ▀▀█▄▄ █ ▄█▄▄▄▄█ ██
█ █▄▄ █▄▄ █▄ ▄▄▄ █▀█ ▄ █
█▄█ ▄▄█ █▄ █▄▄ █ █ █ █ █
█ ▄▄▄ █▄ █ █ ▄▄█▄█▄▄▄█ █
█ █ ▄▄ █▄▄▄█▄▄▄▄ █████ █
█ ▀▀██  ▄ █ ▄█ █▄▄ ███ █
█▀▀ █▀▀▀█ █ ██▄▄ █▄▄ █ █
██ █▀ █ █ ▄▄▄▄ █ ▄ █ █ █
█ ▄██▄ █ ▄▄▄ █ █ █ █▄▄▄█
█ ▀▀▀ ▄█ ▄ ▀▀█  ▄█    F█
▀▀▀▀▀▀▀▀▀▀▀▀▀▀▀▀▀▀▀▀▀▀▀▀
