▄▄▄▄▄▄▄▄▄▄▄▄▄▄▄▄▄▄▄▄▄▄▄▄
█ █ ▄▄▄▄ █S▄▄ █▄ ▄▄▄ ▄▄█
█ █▄ █ ▄▄█▄ █ █ ▄█ █▄▄ █
█  █ █▄ █ ▄▄█▄▄ █ ▄▄ █ █
█ █ ▄█▄▄█ ▄▄  █▄▄▄█  ▀▀█
█ █ ▄▄▄▄▄▄▄█▄▄▄▄▄ █ █▄ █
█ █ █ █  █ ▄  ▄ █▄█▄▄█ █
█▄▄▄█▄▄█▄  █▀▀▀▄▄▄ █ ▄▄█
█ ▄▄▄▄ █ ▄▄█▄▄▄ █ ▄█▄  █
█ █▄▄▄▄█▄ ▄▄█   █ █ ▄▄ █
█ █ ▄▄▄ █ █ █ █▄▄▄█ █ ▄█
█ █▄  █ ▄▄█ █ █ ▄▄▄▄█  █
█ ▄▀ █▀ █ ▄▄▄ █ █ ▄█ ▄██
█ ▀  ▀▀█▀ █  ▄█▄  ▀█ █ █
█ ▀▀█ █▀▀█▀▀ ▄▄ ▀▀ █ █ █
█ █ █ █▄ ▀▀▀▀▀▀▀▀▀▀█ █ █
█ █ █    █ █ █ █ █▄█▄▄ █
█   ▀▀▀█ █ █▄█▀█ ▄ █ ▄ █
█ █▀██ █ █▄▄▄▄▄█▄█ █▄█ █
█ ▀ █  █ ▄ █F▄ ▀ ▄  █  █
▀▀▀▀▀▀▀▀▀▀▀▀▀▀▀▀▀▀▀▀▀▀▀▀
