▄▄▄▄▄▄▄▄▄▄▄▄▄▄▄▄▄▄▄▄▄▄▄▄
█                      █
█      ▄██████▄        █
█      █     ██        █
█           ██         █
█          ██          █
█         ██           █
█        ██            █
█       ██             █
█      █████████       █
█                      █
█                      █
█                      █
█                      █
█                      █
█                      █
█                      █
█                      █
█                      █
█                      █
▀▀▀▀▀▀▀▀▀▀▀▀▀▀▀▀▀▀▀▀▀▀▀▀