▄▄▄▄▄▄▄▄▄▄▄▄▄▄▄▄▄▄▄▄▄▄▄▄
█ ▀ █▄▄▄ █▀ █▀▀▀▀█S▀▀▀ █
█▄ █ ▄▄▄▄▄ ▀▀ █▀▀▀▀▀ █ █
█ ▄ ▄▄▄█ █ █▀▀▀ █▀▀█ █▄█
█ █ █ ▄▄ █▄▄▄ ▀▀█ ▀   ▀█
█▀▀ █ █▀▄▄▄▄ █▀▄ ▀▀▀▀▄ █
██ ▀▀ █ ▄▄ █ █▄▄▄ █ ▄ ▀█
██ █▀▀ ▄▄█ █▄▄▄▄▄▄█ ▀▀▀█
█  █ ▄▀▀▀█▄▄▄▄▄▄▄ █ ▀▄ █
█ ██▄▄▄▄▄▄▄▄▄▄▄ █▄ █ ▀▄█
█▄▄▄▄▄▄▄ █▄▄▄▄▄▄ █▄ █ ▀█
██▀▀▀██ ▄▄▄▄▄  ▀▄ █▄ █ █
██ ▀▀██▄▄▄ █▀▀ ▄ ▄██▄▄▄█
██ █▄▄▄  █▄ █ ▄█ ▄▄▄ ▄▄█
█ ▄▀ █▄ █▄▄▄█▄ ▀ █ █▄ ██
█ ▀ ▀██ █▄▄ █▄▄▄█ ▄▄▄▄██
█ ▄▄▄ ▀▄▄▄▄ ▀▀▀ █ ██▀▀ █
██▀▀▀█▄▄ █ ▄▀ ▀██▄▄▄▄▀ █
██ ▄▄▄ ▄▄█ ▀█▄▄ ▀ ▄▄▄▄▀█
█  ▀F█ █ ▄ ▄   █ ▄▄▄ ▀ █
▀▀▀▀▀▀▀▀▀▀▀▀▀▀▀▀▀▀▀▀▀▀▀▀
