▄▄▄▄▄▄▄▄▄▄▄▄▄▄▄▄▄▄▄▄▄▄▄▄
█                      █
█      ▄██████▄        █
█      █     ██        █
█            ██        █
█          ██          █
█            ██        █
█      █     ██        █
█       ██████         █
█                      █
█                      █
█                      █
█                      █
█                      █
█                      █
█                      █
█                      █
█                      █
█                      █
█                      █
▀▀▀▀▀▀▀▀▀▀▀▀▀▀▀▀▀▀▀▀▀▀▀▀