▄▄▄▄▄▄▄▄▄▄▄▄▄▄▄▄▄▄▄▄▄▄▄▄
█S▄▄ █▀▀▀▀▀█▀▀█ ▄ ▄▄▄▄ █
█ ▄▄ ▀▀█ █▄▄▄ █ █ █  █ █
█ █ █▀  ▄▄▄ █ █ ▄▄ █ █ █
█ ▄▄ ▀▀ █ █ █▀  ██ █ █ █
█▄▄ ▄ █▄▄ █    █ █   █ █
█   █ █▄▄  ▀█▀▀  █ █▀▀ █
█ ▀▀▀ █   █ █ ██ █ █ ███
█▀▀▀█▀▀ █ █ █ █  █ █▄▄ █
█ █ █ █ █ █   █  █ █ █ █
█ █ █▀▀     █▀█▀▀▀ █ █ █
█▄▄ █▀▀▀▀▀█ █   ██ ▄ █ █
█   ▀  █ █▀▀▀▀▀▀▀▀████ █
█ ▀█▄▄▄█▄█ █▀▀▀▀▀      █
█  █     █ █ █████████ █
██ █ █ █ █ █▄▄▄ ▄ ▄▄ █ █
██ █ █ █▄▄▄█▄▄▄▄█▄▀  █ █
██ █ █ █   ▄     ███ █ █
██ █ █▄█ █ █ ▀▀█ █▄▄▄███
█ ▄█     █ █ █ █      F█
▀▀▀▀▀▀▀▀▀▀▀▀▀▀▀▀▀▀▀▀▀▀▀▀
