▄▄▄▄▄▄▄▄▄▄▄▄▄▄▄▄▄▄▄▄▄▄▄▄
█ ▄▄▄▄▄▄▄ █S▄▄▄▄▄▄ █   █
█ █  █ ▄█ █▄▄▄▄▄ █▄▄▄█ █
█ █ █   █ ▄▄▄▄▄ ▄█▄▄ ▄▄█
█ █▄▄█ █▄▄█ ▄▄█▄▄▄ █ █ █
█ ▄ █ ▄█▄   ▄ █  █ █ █ █
█ █ █ ▀  ▄▄ ▀ █▄ █ █▄▄▄█
█ █ █▄▄█▄ █ ▀█   █ █▄▄ █
█ █▄ █ █ ▄█▀ █▄▄ █ █ ▄▄█
█▄ █ █▄▄▄█ ▀█▀   █ ▀▄▄ █
█  █ █ ▄ ▀▀ █▀█ ▄█▄▄ █ █
█▀ █ ▀▀▀▀▀█ █   ▄▄▄▄▄▄ █
█ █▀  ▄▄▄ █ █ █ █▄▄▄ █ █
█▀▀  ▀█ ▄▄█ █ █ ▀▀▀▀ █ █
█ █▀▀ █▄█ ▀ █ ▀▀▀▀▀█ █ █
█ █ ▀▀ █  ▀▀▀▀▀▀▀▀▀█ █ █
█ █▄▄█ ▀▀▀▀▀▀▀ █▀▀ █ ▀▀█
█ █  ▀▄█▀ █ ▀█▀ ▄▀█▀▀▀ █
█ ▄▄█  █▄█ █▄ ▀█▀  █ █▀█
█    █    ▄ F█  ▄▀ █   █
▀▀▀▀▀▀▀▀▀▀▀▀▀▀▀▀▀▀▀▀▀▀▀▀
