▄▄▄▄▄▄▄▄▄▄▄▄▄▄▄▄▄▄▄▄▄▄▄▄
█                      █
█      ▄██████         █
█      ██              █
█      ██              █
█       ██████         █
█            ██        █
█      ▄▄    ██        █
█       ██████         █
█                      █
█                      █
█                      █
█                      █
█                      █
█                      █
█                      █
█                      █
█                      █
█                      █
█                      █
▀▀▀▀▀▀▀▀▀▀▀▀▀▀▀▀▀▀▀▀▀▀▀▀