▄▄▄▄▄▄▄▄▄▄▄▄▄▄▄▄▄▄▄▄▄▄▄▄
█▀▀S▄▄▄▄ ▄▄▄▄▄ █ █▀▀▀▀▀█
█ █ █ ▄ ▄▄▄▄▄▄▄▄▄█ █▀▀ █
█ █ █ █ █ █     ██ █ ███
█ █ ▄▄▄▄▄ █ █ █ ▀█ █ ▀▀█
█ █ █ ▄▄▄▄█ █▄█▄▄▄▄███ █
█ █ █▄▄▄▄ █ █▀▀▀▀▀▀▀▀▀ █
█ █ █ ▄▄▄▄█ █ ███▄█▄████
█▄▄ ▀▀▀▀▀▀▀ █ █▀ ▄▄▄▄  █
█▄▄▄█▄█▄█▄█▄█ █▄ █████ █
█▀▀▀▀▀▀▀▀▀▀▀▀ ▄█ █ ▄▄ ▄█
█ ▀█▀▀▀▀█▀▀▀█▀ ▄ █ █  ▀█
█▄ ▀ ██▄▄ ▀▀▀ █ ▄▀ ▄▄ ▄█
█▀▀█▀▄▄ ▀▀▀▀▀▀█▀▀▄ █  ▀█
█▀ █   ██ █▀▀ █ ▀▀█ █▄ █
█▄ ▀ █ █▄ ██▄ █ ▀▄▀ ▄█ █
█ ▄▄▄█ ▀█ █ ▄ █ ▀ ▄ ▀█ █
█ ▄▄ █ █▄  █   ▀▀▀▀▀▀ ▄█
█ █ ▄█▄▄▄▄█▀▀▀▀▀▀▀▀▄▄▄▄█
█ █ ▀ ▄ ▀ ▄ ▄█ █ █▄F████
▀▀▀▀▀▀▀▀▀▀▀▀▀▀▀▀▀▀▀▀▀▀▀▀
